* * * * * * * * * * * * * * * * * * * * * * * * * * *
* * * * * * * * * * * * * * * * * * * * * * * * * * *
* * * *                 * * * * * * * * * * * * * * *
* * *     * *       *   * * * * * * * * * * * * * * *
*         * *     * *   * * * * * * * * * * * * * * *
*     *   * * *   *     * * * * * * * * * * * * * * *
* *   *   * * *   *   *     * * * *   * * * * * * * *
* *   *   * * *   *     #   * * * *   *     * * * * *
* *   *   * * *   *   *     *               * * * * *
* *   * & * * *   *         #       * * *   * * * * *
* *   * * * * *   *   * *   * *   * * * *   * * * * *
*         * *     *     *     *       * *     * * * *
*           *           * @       #   * &       * * *
*   *   #   *   * * * * *   * *   * * *       & * * *
*       #   *       * * &   *     * * * *   * * * * *
*   *               * *         * *         * * * * *
*   *   * *   *           *     * * *   * * * * * * *
*   * * * * *   * * *     *       *   * * * * * * * *
    * *     *         *   * * * * *   *           * *
            * * * * *                 *   * * *   * *
* * *   *   * * * * *     * * * * *   *   * & *   * *
* * *                                         *   * *
* * *   * * * *   * * *   * * *   * * * * *   *   * *
* * *                                             * *
* * * * * * * * * * * * * * * * * * * * * * * * * * *