***************************
***************************
****        ***************
***  **   * ***************
*    **  ** ***************
*  * *** *  ***************
** * *** * *  **** ********
** * *** *  # **** *  *****
** * *** * *  *       *****
** *&*** *    #   *** *****
** ***** * ** ** **** *****
*    **  *  *  *   **  ****
*     *     *@   # *&   ***
* * # * ***** ** ***   &***
*   # *   **& *  **** *****
* *       **    **    *****
* * ** *     *  *** *******
* ***** ***  *   * ********
  **  *    * ***** *     **
      *****        * *** **
*** * *****  ***** * *&* **
***                    * **
*** **** *** *** ***** * **
***                      **
***************************