*  *******
*@# ******
** *******
** ****&**
*  **** **
*  **** **
*       **
******  **
**********