*     * * * * * * *
* @ #   * * * * * *
* *   * * * * * * *
* *   * * * * & * *
*     * * * *   * *
*     * * * *   * *
*               * *
* * * * * *     * *
* * * * * * * * * *