#######  ^
#     #  ^
#  BB #  ^
# B BP#  ^
#$$####  ^
#$$#     ^
####     ^
         ^
         ^
         ^