##########
#     #  #
#  B     #
# ##     #
#   $$#  #
#   ##   #
###      #
#  B     #
P     B $#
##########