####     ^
#  #     ^
#P$ #    ^
#$$B#    ^
# BB #   ^
#    #   ^
######   ^
         ^
         ^
         ^