-1  0  0  0  0 -1 -1 -1 -1 -1
 0  0  1  1  0 -1 -1 -1 -1 -1
 0  3  2  1  0 -1 -1 -1 -1 -1
 0  0  2  1  0  0 -1 -1 -1 -1
 0  0  1  2  1  0 -1 -1 -1 -1
 0  4  2  1  1  0 -1 -1 -1 -1
 0  4  4  5  4  0 -1 -1 -1 -1
 0  0  0  0  0  0 -1 -1 -1 -1
-1 -1 -1 -1 -1 -1 -1 -1 -1 -1
-1 -1 -1 -1 -1 -1 -1 -1 -1 -1