***@**************************
*** ***                    ***
*** *** ****************** ***
*** *** ****************** ***
*** *** ********* ******** ***
*** *** ********* ******** ***
*** ***                *** ***
*** ************* ******** ***
*** ************* ******** ***
*** ************* ******** ***
***               ******** ***
************************** ***
******************         ***
*           ************** ***
* ********* ************** ***
* ********* **************   *
* ****                     ***
* ************** *************
* **************       *******
* ****************************
